Abbreviations assembly data

AAPS = Aaptos sp.
AMQU = Amphimedon queenslandica
CELE = Crella (Crella) elegans
CVAR = Cliona varians
DANT = Denrilla antarctica
FORS = Forcepia sp.
GATL = Geodia atlantica
HAMB = Haliclona (Gellius) amboinensis
HCIN = Haliclona (Reniera) cinerea
HIND = Haliclona (Rhizoniera) indistincta
HOCU = Haliclona (Haliclona) oculata
HPAN = Halichondria (Halichondria) panicea
HSIM = Haliclona (Haliclona) simulans
HTUB = Haliclona (Reniera) tubifera
HVIS = Haliclona (Rhizoniera) viscosa
SFAS = Sarcotragus fasciculatus
ISOS = Isodictya sp.
KVAR = Kir7kpatricka variolosa
LAPI = Lantrunculia (Lantrunculia) apicalis
LCHO = Lendenfeldia chondrodes
MCEC = Mycale (Carmia) cecilia
MPHY = Mycale (Carmia) phylophylla
MYXS = Myxilla sp.
NCOM = Neopetrosia compacta
PFIC = Petrosia (Petrosia) ficiformis
PFOL = Phyllospongia foliascens
PSPI = Pleraplysilla spinifera
PSUB = Pseudospongosorites suberitoides
SCAR = Stylissa carteri
SCSP = Scopalina sp.
SOFF = Spongia (Spongia) officinalis
STES = Stelligera sp.
TANH = Tedania (Tedania) anhelans
TEDS = Tedania sp.
TPAP = Tentorium papillatum
TWIL = Tethya wilhelma
XTES = Xestospongia testudinaria
VASP = Vaceletia sp.
CSTI = Cymbastela stipitata
